1
**********
*+O++++++*
*++++++@+*
*++++++++*
*++++++++*
*++++++.+*
*++++++++*
*++++++++*
*++++++++*
**********
2
**********
**********
**********
*****++***
*****@+++*
*++++..*+*
*O++@+.@+*
*****++***
*****++***
**********
